id,groups,sub_categories,categories,person,keyword,count,total_event,period_1_plus,period_1_minus,period_1_total,period_2_plus,period_2_minus,period_2_total,period_1_plus_percentage,period_1_minus_percentage,period_2_plus_percentage,period_2_minus_percentage
26,กกต.,สายองค์กรอิสระ,ศาล & องค์กรอิสระ,คณะกรรมการการเลือกตั้ง,"คณะกรรมการการเลือกตั้ง , กกต.",353,353,40,-53,93,147,-113,260,43.01075268817204,56.98924731182796,56.53846153846154,43.46153846153846
27,ป.ป.ช.,สายองค์กรอิสระ,ศาล & องค์กรอิสระ,คณะกรรมการป้องกันและปราบปรามการทุจริตแห่งชาติ,"คณะกรรมการป้องกันและปราบปรามการทุจริตแห่งชาติ , ป.ป.ช. , ปปช.",277,277,23,-91,114,102,-61,163,20.175438596491226,79.82456140350878,62.57668711656442,37.423312883435585
23,ศาลรัฐธรรมนูญ,สายศาล,ศาล & องค์กรอิสระ,ศาลรัฐธรรมนูญ,"ศาลรัฐธรรมนูญ , ศาล รธน. , ศาลรธน. , ศาลการเมือง",58,58,2,-12,14,33,-11,44,14.285714285714285,85.71428571428571,75.0,25.0
25,ศาลปกครอง,สายศาล,ศาล & องค์กรอิสระ,ศาลปกครอง,"ศาล ปค.​สูงสุด , ศาล ปค. , ศาลปกครอง , ศาลปกครองสูงสุด , ศาลปกครองกลาง",49,49,6,-8,14,25,-10,35,42.857142857142854,57.14285714285714,71.42857142857143,28.57142857142857
24,ศาลยุติธรรม,สายศาล,ศาล & องค์กรอิสระ,ศาลยุติธรรม,"ศาลอาญาทุจริตและประพฤติมิชอบกลาง , ศาลฎีกาแผนกคดีอาญาผู้ดำรงตำแหน่งทางการเมือง , ศาลปราบทุจริต , ศาลฎีกา , ศาลฎีกาฯ , ศาลยุติธรรม",41,41,0,-4,4,15,-22,37,0.0,100.0,40.54054054054054,59.45945945945946
29,ผผ.,สายองค์กรอิสระ,ศาล & องค์กรอิสระ,ผู้ตรวจการแผ่นดิน,"ผู้ตรวจการแผ่นดิน , ผผ.",9,9,0,-2,2,6,-1,7,0.0,100.0,85.71428571428571,14.285714285714285
28,คตง.,สายองค์กรอิสระ,ศาล & องค์กรอิสระ,คณะกรรมการตรวจเงินแผ่นดิน,"คณะกรรมการตรวจเงินแผ่นดิน , คตง.",1,1,0,0,0,0,-1,1,0.0,0.0,0.0,100.0
5,ประธานคณะองคมนตรี,องคมนตรี,วัง & องคมนตรี,พลเอก เปรม ติณสูลานนท์,"เปรม , ป๋าเปรม",59,59,5,-8,13,43,-3,46,38.46153846153847,61.53846153846154,93.47826086956522,6.521739130434782
2,สมาชิกราชวงศ์จักรี,วัง,วัง & องคมนตรี,พระบาทสมเด็จพระวชิรเกล้าเจ้าอยู่หัว,"พระบาทสมเด็จพระวชิรเกล้าเจ้าอยู่หัว , รัชกาลที่ 10 , ร.10 , ร.๑๐ , สมเด็จพระบรมฯ , ฟ้าชาย",24,24,0,0,0,24,0,24,0.0,0.0,100.0,0.0
1,สมาชิกราชวงศ์จักรี,วัง,วัง & องคมนตรี,ทูลกระหม่อมหญิงอุบลรัตนราชกัญญา สิริวัฒนาพรรณวดี,"ทูลกระหม่อมหญิงอุบลรัตนราชกัญญา สิริวัฒนาพรรณวดี , ทูลกระหม่อมหญิงฯ , ทูลกระหม่อมหญิงอุบลรัตนฯ , ทูลกระหม่อมฯ",7,7,1,0,1,1,-5,6,100.0,0.0,16.666666666666664,83.33333333333334
6,ประธานคณะองคมนตรี,องคมนตรี,วัง & องคมนตรี,พลเอก สุรยุทธ์ จุลานนท์,"สุรยุทธ์ , บิ๊กแอ้ด",6,6,1,-2,3,3,0,3,33.33333333333333,66.66666666666666,100.0,0.0
3,สมาชิกราชวงศ์จักรี,วัง,วัง & องคมนตรี,สมเด็จพระกนิษฐาธิราชเจ้า กรมสมเด็จพระเทพรัตนราชสุดาฯ สยามบรมราชกุมารี,"สมเด็จพระกนิษฐาธิราชเจ้า กรมสมเด็จพระเทพรัตนราชสุดาฯ สยามบรมราชกุมารี , สมเด็จพระเทพฯ , พระเทพฯ",5,5,0,0,0,5,0,5,0.0,0.0,100.0,0.0
265,พรรคการเมือง,สายพรรคการเมือง,พรรคการเมือง & กลุ่มการเมือง,พรรคประชาธิปัตย์,"ประชาธิปัตย์ , ปชป.",1588,1588,134,-1071,1205,161,-222,383,11.120331950207468,88.87966804979253,42.03655352480418,57.96344647519582
273,พรรคการเมือง,สายพรรคการเมือง,พรรคการเมือง & กลุ่มการเมือง,พรรคเพื่อไทย,"เพื่อไทย , พท. , พรรคทักษิณ , พรรคแดงล้มเจ้า , เพื่อแม้ว , พรรคแม้ว , พรรคพ่อแม้ว , ",1127,1127,417,-173,590,235,-302,537,70.6779661016949,29.322033898305083,43.76163873370577,56.23836126629422
30,ครม. ชุดที่ 62,สายพรรคการเมือง,พรรคการเมือง & กลุ่มการเมือง,พลเอก ประยุทธ์ จันทร์โอชา,"ประยุทธ์ , นายกฯประยุทธ์ , บิ๊กตู่ , ประยุทธ์ , ประยุทธ , ตู่ , ลุงตู่ , ลงตู่",507,507,2,-3,5,365,-137,502,40.0,60.0,72.70916334661355,27.290836653386453
263,พรรคการเมือง,สายพรรคการเมือง,พรรคการเมือง & กลุ่มการเมือง,พรรคพลังประชารัฐ,"พลังประชารัฐ , พปชร.",459,459,0,0,0,365,-94,459,0.0,0.0,79.520697167756,20.47930283224401
274,พรรคการเมือง,สายพรรคการเมือง,พรรคการเมือง & กลุ่มการเมือง,พรรคอนาคตใหม่-พรรคก้าวไกล,"อนาคตใหม่ , ก้าวไกล , อนคม. , กก. , อดีตอนาคตใหม่ , อนาคตดับ , อนค. , ส้มเน่า , คณะก้าวหน้า",447,447,4,-3,7,184,-256,440,57.14285714285714,42.857142857142854,41.81818181818181,58.18181818181818
264,พรรคการเมือง,สายพรรคการเมือง,พรรคการเมือง & กลุ่มการเมือง,พรรคภูมิใจไทย,"ภูมิใจไทย , ภท. , ภูมิใจห้อย , ",292,292,26,-41,67,161,-64,225,38.80597014925373,61.19402985074627,71.55555555555554,28.444444444444443
288,คนเบื้องหลังพรรคการเมือง,สายพรรคการเมือง,พรรคการเมือง & กลุ่มการเมือง,ทักษิณ ชินวัตร,"ทักษิณ ชินวัตร , แม้ว , นช.แม้ว , โทนี่ , พี่โทนี่",253,253,66,-150,216,26,-11,37,30.555555555555557,69.44444444444444,70.27027027027027,29.72972972972973
93,ส.ส. ชุดที่ 25,สายพรรคการเมือง,พรรคการเมือง & กลุ่มการเมือง,อภิสิทธิ์ เวชชาชีวะ,"อภิสิทธิ์ , มาร์ค , หล่อใหญ่",219,219,47,-126,173,16,-30,46,27.167630057803464,72.83236994219652,34.78260869565217,65.21739130434783
31,ครม. ชุดที่ 62,สายพรรคการเมือง,พรรคการเมือง & กลุ่มการเมือง,พลเอก ประวิตร วงษ์สุวรรณ,"ประวิตร , บิ๊กป้อม , ปิ๊กป้อม , ลุงป้อม , ป้อม",207,207,0,-1,1,180,-26,206,0.0,100.0,87.37864077669903,12.62135922330097
34,ครม. ชุดที่ 62,สายพรรคการเมือง,พรรคการเมือง & กลุ่มการเมือง,อนุทิน ชาญวีรกูล,"อนุทิน , เสี่ยหนู , หมอหนู",116,116,2,-5,7,92,-17,109,28.57142857142857,71.42857142857143,84.40366972477065,15.59633027522936
116,ส.ส. ชุดที่ 25,สายพรรคการเมือง,พรรคการเมือง & กลุ่มการเมือง,อนุทิน ชาญวีรกูล,"อนุทิน , เสี่ยหนู , หมอหนู",116,116,2,-5,7,92,-17,109,28.57142857142857,71.42857142857143,84.40366972477065,15.59633027522936
139,ส.ส. ชุดที่ 25,สายพรรคการเมือง,พรรคการเมือง & กลุ่มการเมือง,ธนาธร จึงรุ่งเรืองกิจ,"ธนาธร , ตี๋เนรคุณ , พ่อของฟ้า , พ่อน้องฟ้า , ทอน",88,88,0,0,0,48,-40,88,0.0,0.0,54.54545454545454,45.45454545454545
33,ครม. ชุดที่ 62,สายพรรคการเมือง,พรรคการเมือง & กลุ่มการเมือง,วิษณุ เครืองาม,"วิษณุ , รองฯ วิษณุ",85,85,0,0,0,79,-6,85,0.0,0.0,92.94117647058823,7.0588235294117645
266,พรรคการเมือง,สายพรรคการเมือง,พรรคการเมือง & กลุ่มการเมือง,พรรคชาติไทยพัฒนา,"ชาติไทยพัฒนา , ชทพ.",81,81,19,-10,29,39,-13,52,65.51724137931035,34.48275862068966,75.0,25.0
249,ส.ว. ชุดที่ 12,สายกลุ่มการเมือง,พรรคการเมือง & กลุ่มการเมือง,พลเอก อภิรัชต์ คงสมพงษ์,"อภิรัชต์ , พล.อ.อภิรัชต์ , บิ๊กแดง , ลูกบิ๊กจ๊อด",67,67,0,-1,1,60,-6,66,0.0,100.0,90.9090909090909,9.090909090909092
114,ส.ส. ชุดที่ 25,สายพรรคการเมือง,พรรคการเมือง & กลุ่มการเมือง,ธนกร วังบุญคงชนะ,ธนกร,66,66,0,0,0,64,-2,66,0.0,0.0,96.96969696969697,3.0303030303030303
165,ส.ส. ชุดที่ 25,สายพรรคการเมือง,พรรคการเมือง & กลุ่มการเมือง,สิระ เจนจาคะ,สิระ,51,51,0,0,0,40,-11,51,0.0,0.0,78.43137254901961,21.568627450980394
94,ส.ส. ชุดที่ 25,สายพรรคการเมือง,พรรคการเมือง & กลุ่มการเมือง,ชวน หลีกภัย,"ชวน , ปธ.ชวน",44,44,2,-10,12,20,-12,32,16.666666666666664,83.33333333333334,62.5,37.5
35,ครม. ชุดที่ 62,สายพรรคการเมือง,พรรคการเมือง & กลุ่มการเมือง,จุรินทร์ ลักษณวิศิษฏ์,จุรินทร์,40,40,0,-5,5,24,-11,35,0.0,100.0,68.57142857142857,31.428571428571427
96,ส.ส. ชุดที่ 25,สายพรรคการเมือง,พรรคการเมือง & กลุ่มการเมือง,จุรินทร์ ลักษณวิศิษฏ์,จุรินทร์,40,40,0,-5,5,24,-11,35,0.0,100.0,68.57142857142857,31.428571428571427
51,ครม. ชุดที่ 62,สายพรรคการเมือง,พรรคการเมือง & กลุ่มการเมือง,ร้อยเอก ธรรมนัส พรหมเผ่า,"ธรรมนัส , ผู้กองนัส",39,39,0,0,0,20,-19,39,0.0,0.0,51.28205128205128,48.717948717948715
196,ส.ส. ชุดที่ 25,สายพรรคการเมือง,พรรคการเมือง & กลุ่มการเมือง,ร้อยเอก ธรรมนัส พรหมเผ่า,"ธรรมนัส , ผู้กองนัส",39,39,0,0,0,20,-19,39,0.0,0.0,51.28205128205128,48.717948717948715
205,ส.ส. ชุดที่ 25,สายพรรคการเมือง,พรรคการเมือง & กลุ่มการเมือง,ร้อยเอก ธรรมนัส พรหมเผ่า,"ธรรมนัส , ผู้กองนัส",39,39,0,0,0,20,-19,39,0.0,0.0,51.28205128205128,48.717948717948715
140,ส.ส. ชุดที่ 25,สายพรรคการเมือง,พรรคการเมือง & กลุ่มการเมือง,ปิยบุตร แสงกนกกุล,"ปิยบุตร , กะปิบูด , บูด",34,34,0,0,0,10,-24,34,0.0,0.0,29.411764705882355,70.58823529411765
123,ส.ส. ชุดที่ 25,สายพรรคการเมือง,พรรคการเมือง & กลุ่มการเมือง,พลตำรวจเอก เสรีพิศุทธ์ เตมียเวส,"เสรีพิศุทธ์ , ป๊าเสรี , วีรบุรุษนาแก",33,33,0,0,0,12,-21,33,0.0,0.0,36.36363636363637,63.63636363636363
61,ครม. ชุดที่ 62,สายพรรคการเมือง,พรรคการเมือง & กลุ่มการเมือง,สนธิรัตน์ สนธิจิรวงศ์,สนธิรัตน์,30,30,0,0,0,24,-6,30,0.0,0.0,80.0,20.0
275,พรรคการเมือง,สายพรรคการเมือง,พรรคการเมือง & กลุ่มการเมือง,พรรคเสรีรวมไทย,เสรีรวมไทย,22,22,0,0,0,4,-18,22,0.0,0.0,18.181818181818183,81.81818181818183
41,ครม. ชุดที่ 62,สายพรรคการเมือง,พรรคการเมือง & กลุ่มการเมือง,อุตตม สาวนายน,อุตตม,20,20,0,0,0,13,-7,20,0.0,0.0,65.0,35.0
229,ส.ส. ชุดที่ 25,สายพรรคการเมือง,พรรคการเมือง & กลุ่มการเมือง,ปารีณา ไกรคุปต์,ปารีณา,20,20,0,0,0,8,-12,20,0.0,0.0,40.0,60.0
54,ครม. ชุดที่ 62,สายพรรคการเมือง,พรรคการเมือง & กลุ่มการเมือง,ศักดิ์สยาม ชิดชอบ,ศักดิ์สยาม,19,19,0,0,0,11,-8,19,0.0,0.0,57.89473684210527,42.10526315789473
118,ส.ส. ชุดที่ 25,สายพรรคการเมือง,พรรคการเมือง & กลุ่มการเมือง,ศักดิ์สยาม ชิดชอบ,ศักดิ์สยาม,19,19,0,0,0,11,-8,19,0.0,0.0,57.89473684210527,42.10526315789473
115,ส.ส. ชุดที่ 25,สายพรรคการเมือง,พรรคการเมือง & กลุ่มการเมือง,ไพบูลย์ นิติตะวัน,ไพบูลย์,18,18,0,0,0,15,-3,18,0.0,0.0,83.33333333333334,16.666666666666664
164,ส.ส. ชุดที่ 25,สายพรรคการเมือง,พรรคการเมือง & กลุ่มการเมือง,ไพบูลย์ นิติตะวัน,ไพบูลย์,18,18,0,0,0,15,-3,18,0.0,0.0,83.33333333333334,16.666666666666664
216,ส.ส. ชุดที่ 25,สายพรรคการเมือง,พรรคการเมือง & กลุ่มการเมือง,สุทิน คลังแสง,สุทิน,18,18,0,0,0,1,-17,18,0.0,0.0,5.555555555555555,94.44444444444444
78,ครม. ชุดที่ 62,สายพรรคการเมือง,พรรคการเมือง & กลุ่มการเมือง,สุริยะ จึงรุ่งเรืองกิจ,สุริยะ,16,16,0,0,0,10,-6,16,0.0,0.0,62.5,37.5
105,ส.ส. ชุดที่ 25,สายพรรคการเมือง,พรรคการเมือง & กลุ่มการเมือง,สุริยะ จึงรุ่งเรืองกิจ,สุริยะ,16,16,0,0,0,10,-6,16,0.0,0.0,62.5,37.5
79,ส.ส. ชุดที่ 25,สายพรรคการเมือง,พรรคการเมือง & กลุ่มการเมือง,พิธา ลิ้มเจริญรัตน์,พิธา,16,16,0,0,0,3,-13,16,0.0,0.0,18.75,81.25
141,ส.ส. ชุดที่ 25,สายพรรคการเมือง,พรรคการเมือง & กลุ่มการเมือง,พิธา ลิ้มเจริญรัตน์,"พิธา , ทิม",16,16,0,0,0,3,-13,16,0.0,0.0,18.75,81.25
279,พรรคการเมือง,สายพรรคการเมือง,พรรคการเมือง & กลุ่มการเมือง,พรรคไทยศรีวิไลย์,ไทยศรีวิไลย์,16,16,0,0,0,1,-15,16,0.0,0.0,6.25,93.75
284,พรรคการเมือง,สายพรรคการเมือง,พรรคการเมือง & กลุ่มการเมือง,พรรคเศรษฐกิจไทย,เศรษฐกิจไทย,16,16,0,0,0,4,-12,16,0.0,0.0,25.0,75.0
144,ส.ส. ชุดที่ 25,สายพรรคการเมือง,พรรคการเมือง & กลุ่มการเมือง,พรรณิการ์ วานิช,"พรรณิการ์ , ช่อ",15,15,0,0,0,6,-9,15,0.0,0.0,40.0,60.0
244,ส.ว. ชุดที่ 12,สายกลุ่มการเมือง,พรรคการเมือง & กลุ่มการเมือง,เสรี สุวรรณภานนท์,เสรี,15,15,0,0,0,4,-11,15,0.0,0.0,26.666666666666668,73.33333333333333
60,ครม. ชุดที่ 62,สายพรรคการเมือง,พรรคการเมือง & กลุ่มการเมือง,วราวุธ ศิลปอาชา,วราวุธ,14,14,0,0,0,13,-1,14,0.0,0.0,92.85714285714286,7.142857142857142
130,ส.ส. ชุดที่ 25,สายพรรคการเมือง,พรรคการเมือง & กลุ่มการเมือง,วราวุธ ศิลปอาชา,วราวุธ,14,14,0,0,0,13,-1,14,0.0,0.0,92.85714285714286,7.142857142857142
65,ครม. ชุดที่ 62,สายพรรคการเมือง,พรรคการเมือง & กลุ่มการเมือง,พลเอก อนุพงษ์ เผ่าจินดา,"อนุพงษ์ , ป๊อก , บิ๊กป๊อก , พล.อ.อนุพงษ์",14,14,0,0,0,10,-4,14,0.0,0.0,71.42857142857143,28.57142857142857
66,ครม. ชุดที่ 62,สายพรรคการเมือง,พรรคการเมือง & กลุ่มการเมือง,นิพนธ์ บุญญามณี,นิพนธ์,14,14,0,0,0,9,-5,14,0.0,0.0,64.28571428571429,35.714285714285715
68,ครม. ชุดที่ 62,สายพรรคการเมือง,พรรคการเมือง & กลุ่มการเมือง,สมศักดิ์ เทพสุทิน,สมศักดิ์,14,14,0,0,0,13,-1,14,0.0,0.0,92.85714285714286,7.142857142857142
107,ส.ส. ชุดที่ 25,สายพรรคการเมือง,พรรคการเมือง & กลุ่มการเมือง,สมศักดิ์ เทพสุทิน,สมศักดิ์,14,14,0,0,0,13,-1,14,0.0,0.0,92.85714285714286,7.142857142857142
269,พรรคการเมือง,สายพรรคการเมือง,พรรคการเมือง & กลุ่มการเมือง,พรรคเศรษฐกิจใหม่,"เศรษฐกิจใหม่ , ศม.",14,14,0,0,0,12,-2,14,0.0,0.0,85.71428571428571,14.285714285714285
195,ส.ส. ชุดที่ 25,สายพรรคการเมือง,พรรคการเมือง & กลุ่มการเมือง,ชลน่าน ศรีแก้ว,ชลน่าน,13,13,2,0,2,3,-8,11,100.0,0.0,27.27272727272727,72.72727272727273
204,ส.ส. ชุดที่ 25,สายพรรคการเมือง,พรรคการเมือง & กลุ่มการเมือง,ชลน่าน ศรีแก้ว,ชลน่าน,13,13,2,0,2,3,-8,11,100.0,0.0,27.27272727272727,72.72727272727273
199,ส.ส. ชุดที่ 25,สายพรรคการเมือง,พรรคการเมือง & กลุ่มการเมือง,ศรัณย์วุฒิ ศรัณย์เกตุ,ศรัณย์วุฒิ,12,12,0,0,0,12,0,12,0.0,0.0,100.0,0.0
231,ส.ว. ชุดที่ 12,สายกลุ่มการเมือง,พรรคการเมือง & กลุ่มการเมือง,คำนูณ สิทธิสมาน,คำนูณ,12,12,3,-6,9,2,-1,3,33.33333333333333,66.66666666666666,66.66666666666666,33.33333333333333
59,ครม. ชุดที่ 62,สายพรรคการเมือง,พรรคการเมือง & กลุ่มการเมือง,ชัยวุฒิ ธนาคมานุสรณ์,ชัยวุฒิ,11,11,0,0,0,10,-1,11,0.0,0.0,90.9090909090909,9.090909090909092
111,ส.ส. ชุดที่ 25,สายพรรคการเมือง,พรรคการเมือง & กลุ่มการเมือง,ชัยวุฒิ ธนาคมานุสรณ์,ชัยวุฒิ,11,11,0,0,0,10,-1,11,0.0,0.0,90.9090909090909,9.090909090909092
233,ส.ว. ชุดที่ 12,สายกลุ่มการเมือง,พรรคการเมือง & กลุ่มการเมือง,ถวิล เปลี่ยนศรี,ถวิล,11,11,2,-6,8,2,-1,3,25.0,75.0,66.66666666666666,33.33333333333333
276,พรรคการเมือง,สายพรรคการเมือง,พรรคการเมือง & กลุ่มการเมือง,พรรคประชาชาติ,ประชาชาติ,11,11,0,0,0,3,-8,11,0.0,0.0,27.27272727272727,72.72727272727273
260,ส.ว. ชุดที่ 12,สายกลุ่มการเมือง,พรรคการเมือง & กลุ่มการเมือง,พลตำรวจเอก จักรทิพย์ ชัยจินดา,"จักรทิพย์ , บิ๊กแป๊ะ",10,10,1,0,1,8,-1,9,100.0,0.0,88.88888888888889,11.11111111111111
117,ส.ส. ชุดที่ 25,สายพรรคการเมือง,พรรคการเมือง & กลุ่มการเมือง,ชัย ชิดชอบ,ชัย,10,10,1,-2,3,6,-1,7,33.33333333333333,66.66666666666666,85.71428571428571,14.285714285714285
129,ส.ส. ชุดที่ 25,สายพรรคการเมือง,พรรคการเมือง & กลุ่มการเมือง,มิ่งขวัญ แสงสุวรรณ์,"มิ่งขวัญ , เจ๊มิ่ง",10,10,0,-1,1,4,-5,9,0.0,100.0,44.44444444444444,55.55555555555556
83,ส.ส. ชุดที่ 25,สายพรรคการเมือง,พรรคการเมือง & กลุ่มการเมือง,รังสิมันต์ โรม,"รังสิมันต์ , โรม",9,9,0,0,0,5,-4,9,0.0,0.0,55.55555555555556,44.44444444444444
149,ส.ส. ชุดที่ 25,สายพรรคการเมือง,พรรคการเมือง & กลุ่มการเมือง,รังสิมันต์ โรม,รังสิมันต์,9,9,0,0,0,5,-4,9,0.0,0.0,55.55555555555556,44.44444444444444
109,ส.ส. ชุดที่ 25,สายพรรคการเมือง,พรรคการเมือง & กลุ่มการเมือง,วิรัช รัตนเศรษฐ,วิรัช,9,9,0,0,0,5,-4,9,0.0,0.0,55.55555555555556,44.44444444444444
194,ส.ส. ชุดที่ 25,สายพรรคการเมือง,พรรคการเมือง & กลุ่มการเมือง,ศรีนวล บุญลือ,ศรีนวล,9,9,0,0,0,8,-1,9,0.0,0.0,88.88888888888889,11.11111111111111
203,ส.ส. ชุดที่ 25,สายพรรคการเมือง,พรรคการเมือง & กลุ่มการเมือง,ศรีนวล บุญลือ,ศรีนวล,9,9,0,0,0,8,-1,9,0.0,0.0,88.88888888888889,11.11111111111111
280,พรรคการเมือง,สายพรรคการเมือง,พรรคการเมือง & กลุ่มการเมือง,พรรคไทยรักษาชาติ,"ไทยรักษาชาติ , ทษช.",9,9,0,0,0,4,-5,9,0.0,0.0,44.44444444444444,55.55555555555556
32,ครม. ชุดที่ 62,สายพรรคการเมือง,พรรคการเมือง & กลุ่มการเมือง,สมคิด จาตุศรีพิทักษ์,"สมคิด , รองฯ สมคิด",8,8,0,0,0,3,-5,8,0.0,0.0,37.5,62.5
86,ส.ส. ชุดที่ 25,สายพรรคการเมือง,พรรคการเมือง & กลุ่มการเมือง,อมรัตน์ โชคปมิตต์กุล,"อมรัตน์ , เจี๊ยบ ก้าวไกล , เจี๊ยบ , ส.ส.เจี๊ยบ , เจ๊เจี๊ยบ ก้าวไกล , เจี๊ยบ คอนถม",8,8,0,0,0,1,-7,8,0.0,0.0,12.5,87.5
277,พรรคการเมือง,สายพรรคการเมือง,พรรคการเมือง & กลุ่มการเมือง,พรรคเพื่อชาติ,เพื่อชาติ,8,8,0,0,0,5,-3,8,0.0,0.0,62.5,37.5
39,ครม. ชุดที่ 62,สายพรรคการเมือง,พรรคการเมือง & กลุ่มการเมือง,อนุชา นาคาศัย,อนุชา,7,7,0,0,0,5,-2,7,0.0,0.0,71.42857142857143,28.57142857142857
177,ส.ส. ชุดที่ 25,สายพรรคการเมือง,พรรคการเมือง & กลุ่มการเมือง,อนุชา นาคาศัย,อนุชา,7,7,0,0,0,5,-2,7,0.0,0.0,71.42857142857143,28.57142857142857
56,ครม. ชุดที่ 62,สายพรรคการเมือง,พรรคการเมือง & กลุ่มการเมือง,ถาวร เสนเนียม,ถาวร,7,7,1,-3,4,2,-1,3,25.0,75.0,66.66666666666666,33.33333333333333
77,ครม. ชุดที่ 62,สายพรรคการเมือง,พรรคการเมือง & กลุ่มการเมือง,สาธิต ปิตุเตชะ,สาธิต,7,7,1,-3,4,1,-2,3,25.0,75.0,33.33333333333333,66.66666666666666
227,ส.ส. ชุดที่ 25,สายพรรคการเมือง,พรรคการเมือง & กลุ่มการเมือง,สาธิต ปิตุเตชะ,สาธิต,7,7,1,-3,4,1,-2,3,25.0,75.0,33.33333333333333,66.66666666666666
167,ส.ส. ชุดที่ 25,สายพรรคการเมือง,พรรคการเมือง & กลุ่มการเมือง,จิรายุ ห่วงทรัพย์,จิรายุ,7,7,3,-2,5,0,-2,2,60.0,40.0,0.0,100.0
268,พรรคการเมือง,สายพรรคการเมือง,พรรคการเมือง & กลุ่มการเมือง,พรรคพลังท้องถิ่นไท,พลังท้องถิ่นไท,7,7,0,0,0,4,-3,7,0.0,0.0,57.14285714285714,42.857142857142854
44,ครม. ชุดที่ 62,สายพรรคการเมือง,พรรคการเมือง & กลุ่มการเมือง,สันติ พร้อมพัฒน์,สันติ,6,6,0,0,0,5,-1,6,0.0,0.0,83.33333333333334,16.666666666666664
110,ส.ส. ชุดที่ 25,สายพรรคการเมือง,พรรคการเมือง & กลุ่มการเมือง,สันติ พร้อมพัฒน์,สันติ,6,6,0,0,0,5,-1,6,0.0,0.0,83.33333333333334,16.666666666666664
71,ครม. ชุดที่ 62,สายพรรคการเมือง,พรรคการเมือง & กลุ่มการเมือง,นฤมล ภิญโญสินวัฒน์,นฤมล,6,6,0,0,0,6,0,6,0.0,0.0,100.0,0.0
108,ส.ส. ชุดที่ 25,สายพรรคการเมือง,พรรคการเมือง & กลุ่มการเมือง,นฤมล ภิญโญสินวัฒน์,นฤมล,6,6,0,0,0,6,0,6,0.0,0.0,100.0,0.0
76,ครม. ชุดที่ 62,สายพรรคการเมือง,พรรคการเมือง & กลุ่มการเมือง,กนกวรรณ วิลาวัลย์,กนกวรรณ,6,6,0,0,0,2,-4,6,0.0,0.0,33.33333333333333,66.66666666666666
119,ส.ส. ชุดที่ 25,สายพรรคการเมือง,พรรคการเมือง & กลุ่มการเมือง,กนกวรรณ วิลาวัลย์,กนกวรรณ,6,6,0,0,0,2,-4,6,0.0,0.0,33.33333333333333,66.66666666666666
181,ส.ส. ชุดที่ 25,สายพรรคการเมือง,พรรคการเมือง & กลุ่มการเมือง,นิโรธ สุนทรเลขา,นิโรธ,6,6,0,0,0,5,-1,6,0.0,0.0,83.33333333333334,16.666666666666664
183,ส.ส. ชุดที่ 25,สายพรรคการเมือง,พรรคการเมือง & กลุ่มการเมือง,พรพิมล ธรรมสาร,พรพิมล,6,6,0,0,0,6,0,6,0.0,0.0,100.0,0.0
281,พรรคการเมือง,สายพรรคการเมือง,พรรคการเมือง & กลุ่มการเมือง,พรรคกล้า,กล้า,6,6,0,-2,2,4,0,4,0.0,100.0,100.0,0.0
88,ส.ส. ชุดที่ 25,สายพรรคการเมือง,พรรคการเมือง & กลุ่มการเมือง,วิโรจน์ ลักขณาอดิศร,วิโรจน์,5,5,0,0,0,2,-3,5,0.0,0.0,40.0,60.0
157,ส.ส. ชุดที่ 25,สายพรรคการเมือง,พรรคการเมือง & กลุ่มการเมือง,วิโรจน์ ลักขณาอดิศร,วิโรจน์,5,5,0,0,0,2,-3,5,0.0,0.0,40.0,60.0
270,พรรคการเมือง,สายพรรคการเมือง,พรรคการเมือง & กลุ่มการเมือง,พรรคชาติพัฒนา,"ชาติพัฒนา , ชพ.",5,5,0,0,0,4,-1,5,0.0,0.0,80.0,20.0
36,ครม. ชุดที่ 62,สายพรรคการเมือง,พรรคการเมือง & กลุ่มการเมือง,ดอน ปรมัตถ์วินัย,ดอน,4,4,0,0,0,2,-2,4,0.0,0.0,50.0,50.0
45,ครม. ชุดที่ 62,สายพรรคการเมือง,พรรคการเมือง & กลุ่มการเมือง,ดอน ปรมัตถ์วินัย,ดอน,4,4,0,0,0,2,-2,4,0.0,0.0,50.0,50.0
245,ส.ว. ชุดที่ 12,สายกลุ่มการเมือง,พรรคการเมือง & กลุ่มการเมือง,ดอน ปรมัตถ์วินัย,ดอน,4,4,0,0,0,2,-2,4,0.0,0.0,50.0,50.0
38,ครม. ชุดที่ 62,สายพรรคการเมือง,พรรคการเมือง & กลุ่มการเมือง,เทวัญ ลิปตพัลลภ,เทวัญ,4,4,0,0,0,3,-1,4,0.0,0.0,75.0,25.0
134,ส.ส. ชุดที่ 25,สายพรรคการเมือง,พรรคการเมือง & กลุ่มการเมือง,เทวัญ ลิปตพัลลภ,เทวัญ,4,4,0,0,0,3,-1,4,0.0,0.0,75.0,25.0
50,ครม. ชุดที่ 62,สายพรรคการเมือง,พรรคการเมือง & กลุ่มการเมือง,เฉลิมชัย ศรีอ่อน,เฉลิมชัย,4,4,0,0,0,3,-1,4,0.0,0.0,75.0,25.0
85,ส.ส. ชุดที่ 25,สายพรรคการเมือง,พรรคการเมือง & กลุ่มการเมือง,คารม พลพรกลาง,คารม,4,4,0,0,0,2,-2,4,0.0,0.0,50.0,50.0
154,ส.ส. ชุดที่ 25,สายพรรคการเมือง,พรรคการเมือง & กลุ่มการเมือง,คารม พลพรกลาง,คารม,4,4,0,0,0,2,-2,4,0.0,0.0,50.0,50.0
97,ส.ส. ชุดที่ 25,สายพรรคการเมือง,พรรคการเมือง & กลุ่มการเมือง,กรณ์ จาติกวณิช,กรณ์,4,4,0,-1,1,1,-2,3,0.0,100.0,33.33333333333333,66.66666666666666
131,ส.ส. ชุดที่ 25,สายพรรคการเมือง,พรรคการเมือง & กลุ่มการเมือง,นิกร จำนง,นิกร,4,4,0,0,0,2,-2,4,0.0,0.0,50.0,50.0
192,ส.ส. ชุดที่ 25,สายพรรคการเมือง,พรรคการเมือง & กลุ่มการเมือง,สมพงษ์ อมรวิวัฒน์,สมพงษ์,4,4,0,0,0,0,-4,4,0.0,0.0,0.0,100.0
201,ส.ส. ชุดที่ 25,สายพรรคการเมือง,พรรคการเมือง & กลุ่มการเมือง,สมพงษ์ อมรวิวัฒน์,สมพงษ์,4,4,0,0,0,0,-4,4,0.0,0.0,0.0,100.0
215,ส.ส. ชุดที่ 25,สายพรรคการเมือง,พรรคการเมือง & กลุ่มการเมือง,ยุทธพงศ์ จรัสเสถียร,ยุทธพงศ์,4,4,0,-1,1,1,-2,3,0.0,100.0,33.33333333333333,66.66666666666666
286,พรรคการเมือง,สายพรรคการเมือง,พรรคการเมือง & กลุ่มการเมือง,พรรคสร้างอนาคตไทย,สร้างอนาคตไทย,4,4,0,0,0,3,-1,4,0.0,0.0,75.0,25.0
47,ครม. ชุดที่ 62,สายพรรคการเมือง,พรรคการเมือง & กลุ่มการเมือง,จุติ ไกรฤกษ์,จุติ,3,3,0,-2,2,1,0,1,0.0,100.0,100.0,0.0
98,ส.ส. ชุดที่ 25,สายพรรคการเมือง,พรรคการเมือง & กลุ่มการเมือง,จุติ ไกรฤกษ์,จุติ,3,3,0,-2,2,1,0,1,0.0,100.0,100.0,0.0
48,ครม. ชุดที่ 62,สายพรรคการเมือง,พรรคการเมือง & กลุ่มการเมือง,สุวิทย์ เมษินทรีย์,สุวิทย์,3,3,0,0,0,1,-2,3,0.0,0.0,33.33333333333333,66.66666666666666
58,ครม. ชุดที่ 62,สายพรรคการเมือง,พรรคการเมือง & กลุ่มการเมือง,พุทธิพงษ์ ปุณณกันต์,พุทธิพงษ์,3,3,0,0,0,3,0,3,0.0,0.0,100.0,0.0
106,ส.ส. ชุดที่ 25,สายพรรคการเมือง,พรรคการเมือง & กลุ่มการเมือง,พุทธิพงษ์ ปุณณกันต์,พุทธิพงษ์,3,3,0,0,0,3,0,3,0.0,0.0,100.0,0.0
73,ครม. ชุดที่ 62,สายพรรคการเมือง,พรรคการเมือง & กลุ่มการเมือง,ณัฏฐพล ทีปสุวรรณ,ณัฏฐพล,3,3,0,0,0,1,-2,3,0.0,0.0,33.33333333333333,66.66666666666666
104,ส.ส. ชุดที่ 25,สายพรรคการเมือง,พรรคการเมือง & กลุ่มการเมือง,ณัฏฐพล ทีปสุวรรณ,ณัฏฐพล,3,3,0,0,0,1,-2,3,0.0,0.0,33.33333333333333,66.66666666666666
166,ส.ส. ชุดที่ 25,สายพรรคการเมือง,พรรคการเมือง & กลุ่มการเมือง,นาวาอากาศเอก อนุดิษฐ์ นาครทรรพ,อนุดิษฐ์,3,3,0,-2,2,1,0,1,0.0,100.0,100.0,0.0
184,ส.ส. ชุดที่ 25,สายพรรคการเมือง,พรรคการเมือง & กลุ่มการเมือง,ปดิพัทธ์ สันติภาดา,ปดิพัทธ์,3,3,0,0,0,0,-3,3,0.0,0.0,0.0,100.0
187,ส.ส. ชุดที่ 25,สายพรรคการเมือง,พรรคการเมือง & กลุ่มการเมือง,ชาดา ไทยเศรษฐ์,ชาดา,3,3,0,-1,1,2,0,2,0.0,100.0,100.0,0.0
257,ส.ว. ชุดที่ 12,สายกลุ่มการเมือง,พรรคการเมือง & กลุ่มการเมือง,พลอากาศเอก แอร์บูล สุทธิวรรณ,แอร์บูล,2,2,0,0,0,2,0,2,0.0,0.0,100.0,0.0
99,ส.ส. ชุดที่ 25,สายพรรคการเมือง,พรรคการเมือง & กลุ่มการเมือง,องอาจ คล้ามไพบูลย์,องอาจ,2,2,0,-2,2,0,0,0,0.0,100.0,0.0,0.0
135,ส.ส. ชุดที่ 25,สายพรรคการเมือง,พรรคการเมือง & กลุ่มการเมือง,มงคลกิตติ์ สุขสินธารานนท์,"มงคลกิตติ์ , ด.ช.มงคลกิตติ์ , เต้ มงคลกิตติ์ , เต้  พระราม 7",2,2,0,0,0,1,-1,2,0.0,0.0,50.0,50.0
138,ส.ส. ชุดที่ 25,สายพรรคการเมือง,พรรคการเมือง & กลุ่มการเมือง,นิคม บุญวิเศษ,นิคม,2,2,0,-2,2,0,0,0,0.0,100.0,0.0,0.0
172,ส.ส. ชุดที่ 25,สายพรรคการเมือง,พรรคการเมือง & กลุ่มการเมือง,ณัฐชา บุญไชยอินสวัสดิ์,ณัฐชา,2,2,0,0,0,0,-2,2,0.0,0.0,0.0,100.0
180,ส.ส. ชุดที่ 25,สายพรรคการเมือง,พรรคการเมือง & กลุ่มการเมือง,วีระกร คำประกอบ,วีระกร,2,2,0,0,0,1,-1,2,0.0,0.0,50.0,50.0
220,ส.ส. ชุดที่ 25,สายพรรคการเมือง,พรรคการเมือง & กลุ่มการเมือง,ผ่องศรี แซ่จึง,ผ่องศรี,2,2,0,0,0,2,0,2,0.0,0.0,100.0,0.0
222,ส.ส. ชุดที่ 25,สายพรรคการเมือง,พรรคการเมือง & กลุ่มการเมือง,จารึก ศรีอ่อน,จารึก,2,2,0,0,0,2,0,2,0.0,0.0,100.0,0.0
223,ส.ส. ชุดที่ 25,สายพรรคการเมือง,พรรคการเมือง & กลุ่มการเมือง,สุชาติ ตันเจริญ,สุชาติ,2,2,0,0,0,1,-1,2,0.0,0.0,50.0,50.0
226,ส.ส. ชุดที่ 25,สายพรรคการเมือง,พรรคการเมือง & กลุ่มการเมือง,กวินนาถ ตาคีย์,กวินนาถ,2,2,0,0,0,2,0,2,0.0,0.0,100.0,0.0
234,ส.ว. ชุดที่ 12,สายกลุ่มการเมือง,พรรคการเมือง & กลุ่มการเมือง,ธานี อ่อนละเอียด,ธานี,2,2,0,0,0,1,-1,2,0.0,0.0,50.0,50.0
239,ส.ว. ชุดที่ 12,สายกลุ่มการเมือง,พรรคการเมือง & กลุ่มการเมือง,วันชัย สอนศิริ,วันชัย,2,2,0,0,0,0,-2,2,0.0,0.0,0.0,100.0
285,พรรคการเมือง,สายพรรคการเมือง,พรรคการเมือง & กลุ่มการเมือง,พรรคไทยภักดี,ไทยภักดี,2,2,0,0,0,2,0,2,0.0,0.0,100.0,0.0
261,ส.ว. ชุดที่ 12,สายกลุ่มการเมือง,พรรคการเมือง & กลุ่มการเมือง,พลตำรวจเอก สุวัฒน์ แจ้งยอดสุข,สุวัฒน์,1,1,0,0,0,1,0,1,0.0,0.0,100.0,0.0
37,ครม. ชุดที่ 62,สายพรรคการเมือง,พรรคการเมือง & กลุ่มการเมือง,สุพัฒนพงษ์ พันธ์มีเชาว์,สุพัฒนพงษ์,1,1,0,0,0,0,-1,1,0.0,0.0,0.0,100.0
62,ครม. ชุดที่ 62,สายพรรคการเมือง,พรรคการเมือง & กลุ่มการเมือง,สุพัฒนพงษ์ พันธ์มีเชาว์,สุพัฒนพงษ์,1,1,0,0,0,0,-1,1,0.0,0.0,0.0,100.0
49,ครม. ชุดที่ 62,สายพรรคการเมือง,พรรคการเมือง & กลุ่มการเมือง,เอนก เหล่าธรรมทัศน์,เอนก,1,1,0,0,0,0,-1,1,0.0,0.0,0.0,100.0
55,ครม. ชุดที่ 62,สายพรรคการเมือง,พรรคการเมือง & กลุ่มการเมือง,อธิรัฐ รัตนเศรษฐ,อธิรัฐ,1,1,0,0,0,1,0,1,0.0,0.0,100.0,0.0
212,ส.ส. ชุดที่ 25,สายพรรคการเมือง,พรรคการเมือง & กลุ่มการเมือง,อธิรัฐ รัตนเศรษฐ,อธิรัฐ,1,1,0,0,0,1,0,1,0.0,0.0,100.0,0.0
70,ครม. ชุดที่ 62,สายพรรคการเมือง,พรรคการเมือง & กลุ่มการเมือง,สุชาติ ชมกลิ่น,สุชาติ,1,1,0,0,0,0,-1,1,0.0,0.0,0.0,100.0
224,ส.ส. ชุดที่ 25,สายพรรคการเมือง,พรรคการเมือง & กลุ่มการเมือง,สุชาติ ชมกลิ่น,สุชาติ,1,1,0,0,0,0,-1,1,0.0,0.0,0.0,100.0
80,ส.ส. ชุดที่ 25,สายพรรคการเมือง,พรรคการเมือง & กลุ่มการเมือง,สุรเชษฐ์ ประวีณวงศ์วุฒิ,สุรเชษฐ์,1,1,0,0,0,1,0,1,0.0,0.0,100.0,0.0
145,ส.ส. ชุดที่ 25,สายพรรคการเมือง,พรรคการเมือง & กลุ่มการเมือง,สุรเชษฐ์ ประวีณวงศ์วุฒิ,สุรเชษฐ์,1,1,0,0,0,1,0,1,0.0,0.0,100.0,0.0
81,ส.ส. ชุดที่ 25,สายพรรคการเมือง,พรรคการเมือง & กลุ่มการเมือง,พิจารณ์ เชาวพัฒนวงศ์,พิจารณ์,1,1,0,0,0,0,-1,1,0.0,0.0,0.0,100.0
84,ส.ส. ชุดที่ 25,สายพรรคการเมือง,พรรคการเมือง & กลุ่มการเมือง,สุเทพ อู่อ้น,สุเทพ,1,1,0,0,0,0,-1,1,0.0,0.0,0.0,100.0
153,ส.ส. ชุดที่ 25,สายพรรคการเมือง,พรรคการเมือง & กลุ่มการเมือง,สุเทพ อู่อ้น,สุเทพ,1,1,0,0,0,0,-1,1,0.0,0.0,0.0,100.0
90,ส.ส. ชุดที่ 25,สายพรรคการเมือง,พรรคการเมือง & กลุ่มการเมือง,ณัฐวุฒิ บัวประทุม,ณัฐวุฒิ,1,1,0,0,0,1,0,1,0.0,0.0,100.0,0.0
160,ส.ส. ชุดที่ 25,สายพรรคการเมือง,พรรคการเมือง & กลุ่มการเมือง,ณัฐวุฒิ บัวประทุม,ณัฐวุฒิ,1,1,0,0,0,1,0,1,0.0,0.0,100.0,0.0
103,ส.ส. ชุดที่ 25,สายพรรคการเมือง,พรรคการเมือง & กลุ่มการเมือง,มัลลิกา บุญมีตระกูล มหาสุข,มัลลิกา,1,1,0,-1,1,0,0,0,0.0,100.0,0.0,0.0
112,ส.ส. ชุดที่ 25,สายพรรคการเมือง,พรรคการเมือง & กลุ่มการเมือง,เอกราช ช่างเหลา,เอกราช,1,1,0,0,0,1,0,1,0.0,0.0,100.0,0.0
122,ส.ส. ชุดที่ 25,สายพรรคการเมือง,พรรคการเมือง & กลุ่มการเมือง,เอกราช ช่างเหลา,เอกราช,1,1,0,0,0,1,0,1,0.0,0.0,100.0,0.0
121,ส.ส. ชุดที่ 25,สายพรรคการเมือง,พรรคการเมือง & กลุ่มการเมือง,สำลี รักสุทธี,สำลี,1,1,0,0,0,0,-1,1,0.0,0.0,0.0,100.0
161,ส.ส. ชุดที่ 25,สายพรรคการเมือง,พรรคการเมือง & กลุ่มการเมือง,สำลี รักสุทธี,สำลี,1,1,0,0,0,0,-1,1,0.0,0.0,0.0,100.0
125,ส.ส. ชุดที่ 25,สายพรรคการเมือง,พรรคการเมือง & กลุ่มการเมือง,วิรัตน์ วรศสิริน,วิรัตน์,1,1,0,-1,1,0,0,0,0.0,100.0,0.0,0.0
156,ส.ส. ชุดที่ 25,สายพรรคการเมือง,พรรคการเมือง & กลุ่มการเมือง,นิรามาน สุไลมาน,นิรามาน,1,1,0,0,0,1,0,1,0.0,0.0,100.0,0.0
168,ส.ส. ชุดที่ 25,สายพรรคการเมือง,พรรคการเมือง & กลุ่มการเมือง,ธีรรัตน์ สำเร็จวาณิชย์,ธีรรัตน์,1,1,0,0,0,1,0,1,0.0,0.0,100.0,0.0
173,ส.ส. ชุดที่ 25,สายพรรคการเมือง,พรรคการเมือง & กลุ่มการเมือง,จิรวัฒน์ อรัณยกานนท์,จิรวัฒน์,1,1,0,0,0,1,0,1,0.0,0.0,100.0,0.0
175,ส.ส. ชุดที่ 25,สายพรรคการเมือง,พรรคการเมือง & กลุ่มการเมือง,ไผ่ ลิกค์,ไผ่,1,1,0,0,0,1,0,1,0.0,0.0,100.0,0.0
176,ส.ส. ชุดที่ 25,สายพรรคการเมือง,พรรคการเมือง & กลุ่มการเมือง,พันตำรวจโท ไวพจน์ อาภรณ์รัตน์,ไวพจน์,1,1,0,0,0,0,-1,1,0.0,0.0,0.0,100.0
209,ส.ส. ชุดที่ 25,สายพรรคการเมือง,พรรคการเมือง & กลุ่มการเมือง,วัฒนา ช่างเหลา,วัฒนา,1,1,0,0,0,1,0,1,0.0,0.0,100.0,0.0
211,ส.ส. ชุดที่ 25,สายพรรคการเมือง,พรรคการเมือง & กลุ่มการเมือง,ประเสริฐ จันทรรวงทอง,ประเสริฐ,1,1,0,0,0,1,0,1,0.0,0.0,100.0,0.0
232,ส.ว. ชุดที่ 12,สายกลุ่มการเมือง,พรรคการเมือง & กลุ่มการเมือง,พลอากาศตรี เฉลิมชัย เครืองาม,เฉลิมชัย,1,1,0,0,0,1,0,1,0.0,0.0,100.0,0.0
236,ส.ว. ชุดที่ 12,สายกลุ่มการเมือง,พรรคการเมือง & กลุ่มการเมือง,พลเอก ปรีชา จันทร์โอชา,ปรีชา,1,1,0,0,0,1,0,1,0.0,0.0,100.0,0.0
242,ส.ว. ชุดที่ 12,สายกลุ่มการเมือง,พรรคการเมือง & กลุ่มการเมือง,สมชาย แสวงการ,สมชาย,1,1,0,0,0,1,0,1,0.0,0.0,100.0,0.0
267,พรรคการเมือง,สายพรรคการเมือง,พรรคการเมือง & กลุ่มการเมือง,พรรครวมพลัง,"รวมพลัง , รวมพลังประชาชาติไทย , รพปช.",1,1,0,0,0,1,0,1,0.0,0.0,100.0,0.0
271,พรรคการเมือง,สายพรรคการเมือง,พรรคการเมือง & กลุ่มการเมือง,พรรครักษ์ผืนป่าประเทศไทย,รักษ์ผืนป่าประเทศไทย,1,1,0,0,0,1,0,1,0.0,0.0,100.0,0.0
287,พรรคการเมือง,สายพรรคการเมือง,พรรคการเมือง & กลุ่มการเมือง,พรรครวมไทยสร้างชาติ,รวมไทยสร้างชาติ,1,1,0,0,0,1,0,1,0.0,0.0,100.0,0.0
238,ส.ว. ชุดที่ 12,สายกลุ่มการเมือง,พรรคการเมือง & กลุ่มการเมือง,ศาสตราจารย์ (พิเศษ) พรเพชร วิชิตชลชัย,พรเพชร,0,0,0,0,0,0,0,0,0.0,0.0,0.0,0.0
9,ผบ. ทบ.,สายทหาร,ตำรวจ & ทหาร,พลเอก อภิรัชต์ คงสมพงษ์,"อภิรัชต์ , พล.อ.อภิรัชต์ , บิ๊กแดง , ลูกบิ๊กจ๊อด",67,67,0,-1,1,60,-6,66,0.0,100.0,90.9090909090909,9.090909090909092
20,ผบ. ตร.,สายตำรวจ,ตำรวจ & ทหาร,พลตำรวจเอก จักรทิพย์ ชัยจินดา,"จักรทิพย์ , บิ๊กแป๊ะ",10,10,1,0,1,8,-1,9,100.0,0.0,88.88888888888889,11.11111111111111
17,ผบ. ทอ.,สายทหาร,ตำรวจ & ทหาร,พลอากาศเอก แอร์บูล สุทธิวรรณ,แอร์บูล,2,2,0,0,0,2,0,2,0.0,0.0,100.0,0.0
21,ผบ. ตร.,สายตำรวจ,ตำรวจ & ทหาร,พลตำรวจเอก สุวัฒน์ แจ้งยอดสุข,สุวัฒน์,1,1,0,0,0,1,0,1,0.0,0.0,100.0,0.0
